......................
......................
....#####.......1.....
....#...#.............
....#.................
....#.................
....#.................
....#####.......1.....
......................
......................
......................
......................
..........a...........
......................
......................
......................